wangds	done
shey	done
lm	1sttodo
zhaoh	done
lanac	done
Jß	tie.doc
yuan	1sttodo
mall	1st todo-tip
huangxl	1sttodo	done	todo	todo.txt.bak
liut	done
return	memo.php
zhengm	done	todo.txt.bak
yangyl	done	todo	todo.txt.bak
czec	1sttodo
hbb	1sttodo
chenqj	todo	todo.txt.bak
8	tie.doc
liqb	done
param	memo.php
home	1st todo-tip
wangml	done
htb	1sttodo
chengx	done
echo	memo.php
yuanzl	done	todo	todo.txt.bak
5¥LûÔ	tie.doc
5õÅbø“Ãº_ˆì~Ë­ZEu	tie.doc
chenb	todo	todo.txt.bak
miub	done
miaob	done
p	1sttodo
context	1st todo-tip	help	todo.sh
phone	1st todo-tip
mama	done
work	1st todo-tip
z	tie.doc
hx	1sttodo
hy	1sttodo
zhaoll	done
c2	1sttodo
liujx	done
hmc	1sttodo
chai	1sttodo
yangxh	done
luob	done
jsb	1sttodo
web	1st todo-tip
chengl	done
chenmj	done
chaizt	1sttodo	done
report	1sttodo
zhaoyl	done	todo	todo.txt.bak
chenmq	done	todo	todo.txt.bak
pancp	done
jiml	done
huang	1sttodo
am	1sttodo
cnf	1sttodo
huxk	todo	todo.txt.bak
gcb	1sttodo
zhangz	done
dujp	1sttodo
pns	1sttodo
joan	done
sheyi	done
lium	done	todo	todo.txt.bak
wanglc	done	todo	todo.txt.bak
yaowj	done
xiej	todo	todo.txt.bak
zouh	done
zhouxh	done	todo	todo.txt.bak	work
songjf	done	todo	todo.txt.bak
cgb	1sttodo
yeyf	done
groc	1st todo-tip
hdb	1sttodo
